{
  "1": {
    "map":[
"1111111111111111111",
"1222222222222222221",
"1211121112111211121",
"1222222212122222221",
"1211111212121111121",
"1222231222221322221",
"1211111112111111121",
"1222222222222222221",
"1212111110111112121",

"0222222100012222220",

"1212112111112112121",
"1222222222222222221",
"1211111112111111121",
"1222231222221322221",
"1211111212121111121",
"1222222212122222221",
"1211121112111211121",
"1222222222222222221",
"1111111111111111111"
]
  },

  "2": {
    "map":[
"1111111111111111111",
"1312222222222222131",
"1212111211121112121",
"1212221222221222121",
"1212121112111212121",
"1212121222221212121",
"1222121211121212221",
"1212121222221212121",
"1212121111111212121",

"0211122210122211120",

"1212111211121112121",
"1222222222222222221",
"1211111112111111121",
"1222231222221322221",
"1211111212121111121",
"1222222212122222221",
"1211121112111211121",
"1222222222222222221",
"1111111111111111111"
]
  },

  "3": {
    "map":[
    "11111111111111111",
    "12222212221222221",
    "12111212121211121",
    "12122222222222121",
    "12121111111111121",
    "12122222222222221",
    "12111112121111121",
    "12222222002222221",
    "11111110001111111",
    "12222222002222221",
    "12111112121111121",
    "12222222222222221",
    "12111111111111121",
    "12122222222222121",
    "12111212121211121",
    "12222212221222221",
    "11111111111111111"    ]
  }
}
