{
  "1": {
    "map":[
"0000000000000000000",
"1111111111111111111",
"1222222222222222221",
"1211121112111211121",
"1222222212122222221",
"1211111212121111121",
"1222231222221322221",
"1211111112111111121",
"1222222222222222221",
"0212111115111112120",

"1222222167812222221",

"1212112111112112121",
"1222222222222222221",
"1211111112111111121",
"1222231222221322221",
"1211111212121111121",
"1222222212122222221",
"1211121112111211121",
"1222222229222222221",
"1111111111111111111"
]
  },

  "2": {
    "map":[
"0000000000000000000",
"1111111111111111111",
"1312222222222222131",
"1212111211121112121",
"1212221222221222121",
"1212121112111212121",
"1212121222221212121",
"1222122211122212221",
"1212121222221212121",
"0212121115111212120",

"1211122167812211121",

"1212112111112112121",
"1222222222222222221",
"1211111112111111121",
"1222231222221322221",
"1211111212121111121",
"1222222212122222221",
"1211121112111211121",
"1222222229222222221",
"1111111111111111111"
]
  },

  "3": {
    "map":[
    "00000000000000000",
    "11111111111111111",
    "12222212221222221",
    "12111212121211121",
    "12122222222222121",
    "12221111111111121",
    "12122222222222221",
    "12111211511211121",
    "12222216781222221",

    "02111211111211120",

    "12222222222222221",
    "12111112121111121",
    "12222222222222221",
    "12121111111112121",
    "12122222222222121",
    "12111212121211121",
    "12222212921222221",
    "11111111111111111"
    ]
  }
}
